!!!!!!!!!!
!00000000!
!0!!0!000!
!0!000000!
!0!0*!000!
!0!00!000!
!0!!!!000!
!00000000!
!00000000!
!00000000!
!00000000!
!00000000!
!00000000!
!!!!!!!!!!
